q	Q
w	W
e	E
r	R
t	T
y	Y
u	U
i	I
o	O
p	P
a	A
s	S
d	D
f	F
g	G
h	H
j	J
k	K
l	L
z	Z
x	X
c	C
v	V
b	B
n	N
m	M
á	Á
é	É
í	Í
ó	Ó
ú	Ú
ḿ	Ḿ
ń	Ń	
à	À
è	È
ì	Ì
ò	Ò
ù	Ù
m̀	M̀
ǹ	Ǹ	
â	Â
ê	Ê
î	Î
ô	Ô
û	Û
m̂	M̂
n̂	N̂	
ǎ	Ǎ
ě	Ě
ǐ	Ǐ
ǒ	Ǒ
ǔ	Ǔ
m̌	M̌
ň	Ň
ā	Ā
ē	Ē
ī	Ī
ō	Ō
ū	Ū
m̄	M̄
n̄	N̄
ⁿ	ᴺ